00000000000000,
11111000011111,
11111000011111,
11111000011111,
00000000000000,
00000000000000,
11111000011111,
11111000011111,
11111000011111,
00000000000000,
00011100111000,
00001000010000