10100010001000,
10100010001000,
10101010101010,
10101010101010,
10101010101010,
10101010101010,
10101010101010,
10101010101010,
10101010101010,
10001000100010,
10001000100010,
11111111111110