11111111111111,
11111111111111,
10000000000001,
10000000000001,
10000000000001,
10000000000001,
10011111111111,
10011111111111,
10000000000001,
10000000000001,
10000000000001,
10000000000001,
11111111111001,
11111111111001