00011111111000,
00111111111100,
01111111111110,
01110011011110,
11000000000110,
11000000000110,
01110011011110,
01111111111110,
00111111111100,
00011111111000,