00001111110000,
10000111100001,
11000011000011,
11100000000111,
11110000001111,
11111000011111,
11110000001111,
11100011000111,
11000111100011,
10001111110001,
00011111111000,
00000000000000,
11100111100111,
01000011000010