00000000000000,
00000000000000,
00000010000000,
00000010000000,
00000111000000,
00000111000000,
00000111000000,
00001111100000,
00001111100000,
00000111000000,
00000111000000,
00000111000000,
00000010000000,
00000010000000