00000000000000,
00001000010000,
00011100111000,
00111111111100,
00111111111100,
00011111111000,
10001111110001,
01000111100010,
00100011000100,
00010000001000,
00001000010000