00001100110000,
00111111111100,
01111111111110,
11111111111111,
11111111111111,
01111111111110,
00111111111100,
00011111111000,
00001111110000,
00000111100000,
00000011000000,